1111111111111
1P00000000001
1000111111001
100C000001001
1110111011011
10000000000E1
1111111111111
