1111111111111
1P00000000001
10000010000C1
100001C100001
100001E100001
1000000000001
1000C00000001
1111111111111
