1111111111111
1P10000000001
1000000000C01
1000011100001
100001E100001
1000000000001
1001C10000A01
1111111111111